{
  "data": [
    [ 10, 11, 12, 13, 14, 15, 16, 10, 11, 12 ],
    [ 13, 11, 10, 12, 12, 15, 16, 10, 16, 10 ],
    [ 12, 10, 16, 13, 14, 15, 16, 16, 13, 12 ],
    [ 10, 11, 12, 13, 14, 15, 16, 10, 11, 12 ],
    [ 13, 11, 10, 12, 12, 15, 16, 10, 16, 10 ],
    [ 12, 10, 16, 13, 14, 15, 16, 16, 13, 12 ],
    [ 10, 11, 12, 13, 14, 15, 16, 10, 11, 12 ],
    [ 13, 11, 10, 12, 12, 15, 16, 10, 16, 10 ],
    [ 12, 10, 16, 13, 14, 15, 16, 16, 13, 12 ],
    [ 10, 11, 12, 13, 14, 15, 16, 10, 11, 12 ],
    [ 10, 11, 12, 13, 14, 15, 16, 10, 11, 12 ],
    [ 13, 11, 10, 12, 12, 15, 16, 10, 16, 10 ],
    [ 12, 10, 16, 13, 14, 15, 16, 16, 13, 12 ],
    [ 10, 11, 12, 13, 14, 15, 16, 10, 11, 12 ],
    [ 13, 11, 10, 12, 12, 15, 16, 10, 16, 10 ],
    [ 12, 10, 16, 13, 14, 15, 16, 16, 13, 12 ],
    [ 10, 11, 12, 13, 14, 15, 16, 10, 11, 12 ],
    [ 13, 11, 10, 12, 12, 15, 16, 10, 16, 10 ],
    [ 12, 10, 16, 13, 14, 15, 16, 16, 13, 12 ],
    [ 10, 11, 12, 13, 14, 15, 16, 10, 11, 12 ],
    [ 10, 11, 12, 13, 14, 15, 16, 10, 11, 12 ],
    [ 13, 11, 10, 12, 12, 15, 16, 10, 16, 10 ],
    [ 12, 10, 16, 13, 14, 15, 16, 16, 13, 12 ],
    [ 10, 11, 12, 13, 14, 15, 16, 10, 11, 12 ],
    [ 13, 11, 10, 12, 12, 15, 16, 10, 12, 10 ]
  ]
}
